"filename", "language", "Python", "Generic Pseudocode", "XML", "comment", "blank", "total"
"c:\Users\dassh\Documents\NEA\.idea\NEA.iml", "XML", 0, 0, 8, 0, 0, 8
"c:\Users\dassh\Documents\NEA\.idea\inspectionProfiles\profiles_settings.xml", "XML", 0, 0, 6, 0, 0, 6
"c:\Users\dassh\Documents\NEA\.idea\misc.xml", "XML", 0, 0, 4, 0, 0, 4
"c:\Users\dassh\Documents\NEA\.idea\modules.xml", "XML", 0, 0, 8, 0, 0, 8
"c:\Users\dassh\Documents\NEA\.idea\vcs.xml", "XML", 0, 0, 6, 0, 0, 6
"c:\Users\dassh\Documents\NEA\RoboRally\Controller\leaderboard.py", "Python", 5, 0, 0, 1, 1, 7
"c:\Users\dassh\Documents\NEA\RoboRally\Controller\leaderboardController.py", "Python", 0, 0, 0, 0, 1, 1
"c:\Users\dassh\Documents\NEA\RoboRally\Controller\mainMenuController.py", "Python", 42, 0, 0, 2, 10, 54
"c:\Users\dassh\Documents\NEA\RoboRally\Controller\playGameController.py", "Python", 180, 0, 0, 29, 54, 263
"c:\Users\dassh\Documents\NEA\RoboRally\Controller\vsBot.py", "Python", 23, 0, 0, 1, 7, 31
"c:\Users\dassh\Documents\NEA\RoboRally\Model\leaderboardModel.py", "Python", 0, 0, 0, 0, 1, 1
"c:\Users\dassh\Documents\NEA\RoboRally\Model\playGameModel.py", "Python", 3, 0, 0, 1, 3, 7
"c:\Users\dassh\Documents\NEA\RoboRally\View\leaderboardView.py", "Python", 9, 0, 0, 1, 3, 13
"c:\Users\dassh\Documents\NEA\RoboRally\View\mainMenuView.py", "Python", 36, 0, 0, 2, 19, 57
"c:\Users\dassh\Documents\NEA\RoboRally\View\makeGrid.py", "Python", 25, 0, 0, 7, 7, 39
"c:\Users\dassh\Documents\NEA\RoboRally\View\playGameView.py", "Python", 60, 0, 0, 18, 33, 111
"c:\Users\dassh\Documents\NEA\RoboRally\View\registerHandling.py", "Python", 11, 0, 0, 0, 1, 12
"c:\Users\dassh\Documents\NEA\RoboRally\View\rules.py", "Python", 26, 0, 0, 1, 13, 40
"c:\Users\dassh\Documents\NEA\RoboRally\cardsAndRegisters\model.py", "Python", 7, 0, 0, 0, 4, 11
"c:\Users\dassh\Documents\NEA\RoboRally\cardsAndRegisters\view.py", "Python", 29, 0, 0, 0, 6, 35
"c:\Users\dassh\Documents\NEA\RoboRally\main.py", "Python", 18, 0, 0, 8, 8, 34
"c:\Users\dassh\Documents\NEA\pseudocode\aStar.pseudo", "Generic Pseudocode", 0, 21, 0, 0, 11, 32
"c:\Users\dassh\Documents\NEA\pseudocode\instructions.pseudo", "Generic Pseudocode", 0, 24, 0, 0, 6, 30
"c:\Users\dassh\Documents\NEA\pseudocode\mergeSort.pseudo", "Generic Pseudocode", 0, 37, 0, 0, 13, 50
"c:\Users\dassh\Documents\NEA\pseudocode\moveHistory.pseudo", "Generic Pseudocode", 0, 23, 0, 0, 7, 30
"Total", "-", 474, 105, 32, 71, 208, 890