"filename", "language", "Python", "comment", "blank", "total"
"c:\Users\dassh\Documents\NEA\RoboRally\Controller\card.py", "Python", -47, -10, -16, -73
"c:\Users\dassh\Documents\NEA\RoboRally\Controller\cardController.py", "Python", 38, 4, 10, 52
"c:\Users\dassh\Documents\NEA\RoboRally\Controller\playGameController.py", "Python", 84, 5, 22, 111
"c:\Users\dassh\Documents\NEA\RoboRally\Model\cardModel.py", "Python", 6, 0, 1, 7
"c:\Users\dassh\Documents\NEA\RoboRally\Model\registerModel.py", "Python", 5, 0, 1, 6
"c:\Users\dassh\Documents\NEA\RoboRally\View\cardView.py", "Python", 14, 0, 5, 19
"c:\Users\dassh\Documents\NEA\RoboRally\View\playGameView.py", "Python", -43, -9, -11, -63
"c:\Users\dassh\Documents\NEA\RoboRally\View\registerView.py", "Python", 10, 0, 3, 13
"c:\Users\dassh\Documents\NEA\RoboRally\main.py", "Python", 6, 2, -1, 7
"Total", "-", 73, -8, 14, 79