"filename", "language", "Generic Pseudocode", "Python", "XML", "comment", "blank", "total"
"c:\Users\dassh\Documents\NEA\.idea\NEA.iml", "XML", 0, 0, 8, 0, 0, 8
"c:\Users\dassh\Documents\NEA\.idea\inspectionProfiles\profiles_settings.xml", "XML", 0, 0, 6, 0, 0, 6
"c:\Users\dassh\Documents\NEA\.idea\misc.xml", "XML", 0, 0, 4, 0, 0, 4
"c:\Users\dassh\Documents\NEA\.idea\modules.xml", "XML", 0, 0, 8, 0, 0, 8
"c:\Users\dassh\Documents\NEA\.idea\vcs.xml", "XML", 0, 0, 6, 0, 0, 6
"c:\Users\dassh\Documents\NEA\RoboRally\Controller\cardController.py", "Python", 0, 38, 0, 4, 10, 52
"c:\Users\dassh\Documents\NEA\RoboRally\Controller\leaderboard.py", "Python", 0, 5, 0, 1, 1, 7
"c:\Users\dassh\Documents\NEA\RoboRally\Controller\leaderboardController.py", "Python", 0, 0, 0, 0, 1, 1
"c:\Users\dassh\Documents\NEA\RoboRally\Controller\mainMenuController.py", "Python", 0, 41, 0, 2, 10, 53
"c:\Users\dassh\Documents\NEA\RoboRally\Controller\playGameController.py", "Python", 0, 95, 0, 7, 25, 127
"c:\Users\dassh\Documents\NEA\RoboRally\Controller\vsBot.py", "Python", 0, 23, 0, 1, 7, 31
"c:\Users\dassh\Documents\NEA\RoboRally\Model\cardModel.py", "Python", 0, 6, 0, 0, 1, 7
"c:\Users\dassh\Documents\NEA\RoboRally\Model\leaderboardModel.py", "Python", 0, 0, 0, 0, 1, 1
"c:\Users\dassh\Documents\NEA\RoboRally\Model\playGameModel.py", "Python", 0, 3, 0, 1, 3, 7
"c:\Users\dassh\Documents\NEA\RoboRally\Model\registerModel.py", "Python", 0, 5, 0, 0, 1, 6
"c:\Users\dassh\Documents\NEA\RoboRally\View\cardView.py", "Python", 0, 14, 0, 0, 5, 19
"c:\Users\dassh\Documents\NEA\RoboRally\View\leaderboardView.py", "Python", 0, 9, 0, 1, 3, 13
"c:\Users\dassh\Documents\NEA\RoboRally\View\mainMenuView.py", "Python", 0, 36, 0, 2, 19, 57
"c:\Users\dassh\Documents\NEA\RoboRally\View\makeGrid.py", "Python", 0, 25, 0, 7, 7, 39
"c:\Users\dassh\Documents\NEA\RoboRally\View\playGameView.py", "Python", 0, 61, 0, 15, 32, 108
"c:\Users\dassh\Documents\NEA\RoboRally\View\registerHandling.py", "Python", 0, 11, 0, 0, 1, 12
"c:\Users\dassh\Documents\NEA\RoboRally\View\registerView.py", "Python", 0, 10, 0, 0, 3, 13
"c:\Users\dassh\Documents\NEA\RoboRally\View\rules.py", "Python", 0, 26, 0, 1, 13, 40
"c:\Users\dassh\Documents\NEA\RoboRally\main.py", "Python", 0, 21, 0, 6, 8, 35
"c:\Users\dassh\Documents\NEA\pseudocode\aStar.pseudo", "Generic Pseudocode", 21, 0, 0, 0, 11, 32
"c:\Users\dassh\Documents\NEA\pseudocode\instructions.pseudo", "Generic Pseudocode", 24, 0, 0, 0, 6, 30
"c:\Users\dassh\Documents\NEA\pseudocode\mergeSort.pseudo", "Generic Pseudocode", 37, 0, 0, 0, 13, 50
"c:\Users\dassh\Documents\NEA\pseudocode\moveHistory.pseudo", "Generic Pseudocode", 23, 0, 0, 0, 7, 30
"Total", "-", 105, 429, 32, 48, 188, 802